1111111111111
10010C00000C1
1000011111001
1P0C11000C0E1
10010C00000C1
10010C00000C1
10010C00000C1
10010C00000C1
10010C00000C1
10010C00000C1
10010C00000C1
10010C00000C1
10010C00000C1
1111111111111