111111111111111111111111111111
1E0000000000000C00000C00000001
1010010100100000101001000C0011
101001001010101000100100000011
1P0000000C00C000000000000000C1
101001010010000010100100000011
1010010100100000101001C0000011
100000000C00C000000000000000C1
100001100000000000001000000111
100000000C00C000000000000000C1
10100101001000001010010C000011
100001010010000010100100000011
101001010010000010100100000C11
1010C1010010C00010100100C00011
1000010100100000101C0100000011
111111111111111111111111111111