1111111111111
10000C00000C1
1101011111001
1P0C1100C00E1
1111111111111